59 61 1.2
###########################################################
###########  +             +             +             +  #
###########+++++         +++++         +++++         +++++#
###########+++++         +++++         +++++         +++++#
##########  +++ ......... +++ ......... +++ ......... +++ #
##########     .%%%%%%%%%.   .%%%%%%%%%.   .%%%%%%%%%.   .#
X::::::::::++  .%%%%%%%%%.   .%%%%%%%%%.   .%%%%%%%%%.   .#
##########  +++ ......... +++ ......... +++ ......... +++ #
##########. ++++         +++++         +++++         +++++#
##########  ++++         +++++         +++++         +++++#
X::::::::::++++ ......... +++ ......... +++ ......... +++ #
##########     .%%%%%%%%%.   .%%%%%%%%%.   .%%%%%%%%%.   .#
##########.    .%%%%%%%%%.   .%%%%%%%%%.   .%%%%%%%%%.   .#
##########  +++ ......... +++ ......... +++ ......... +++ #
X::::::::::+++++         +++++         +++++         +++++#
##########  ++++         +++++         +++++         +++++#
##########. +++ ......... +++ ......... +++ ......... +++ #
##########     .%%%%%%%%%.   .%%%%%%%%%.   .%%%%%%%%%.   .#
X::::::::::++  .%%%%%%%%%.   .%%%%%%%%%.   .%%%%%%%%%.   .#
##########  +++ ......... +++ ......... +++ ......... +++ #
##########. ++++         +++++         +++++         +++++#
##########  ++++         +++++         +++++         +++++#
X::::::::::++++ ......... +++ ......... +++ ......... +++ #
##########     .%%%%%%%%%.   .%%%%%%%%%.   .%%%%%%%%%.   .#
##########.    .%%%%%%%%%.   .%%%%%%%%%.   .%%%%%%%%%.   .#
##########  +++ ......... +++ ......... +++ ......... +++ #
X::::::::::+++++         +++++         +++++         +++++#
##########  ++++         +++++         +++++         +++++#
##########. +++ ......... +++ ......... +++ ......... +++ #
##########     .%%%%%%%%%.   .%%%%%%%%%.   .%%%%%%%%%.   .#
X::::::::::++  .%%%%%%%%%.   .%%%%%%%%%.   .%%%%%%%%%.   .#
##########  +++ ......... +++ ......... +++ ......... +++ #
##########. ++++         +++++         +++++         +++++#
##########  ++++         +++++         +++++         +++++#
X::::::::::++++ ......... +++ ......... +++ ......... +++ #
##########     .%%%%%%%%%.   .%%%%%%%%%.   .%%%%%%%%%.   .#
##########.    .%%%%%%%%%.   .%%%%%%%%%.   .%%%%%%%%%.   .#
##########  +++ ......... +++ ......... +++ ......... +++ #
X::::::::::+++++         +++++         +++++         +++++#
########## +++++         +++++         +++++         +++++#
##########  +++ ......... +++++++++++++++++ ......... +++ #
###########    .%%%%%%%%%. +++++++++++++++ .%%%%%%%%%.   .#
###########    .%%%%%%%%%. +++++++++++++++ .%%%%%%%%%.   .#
########### +++ ......... +++++++++++++++++ ......... +++ #
###########+++++         +++++++++++++++++++         +++++#
###########+++++         +++++++++++++++++++         +++++#
########### +++           +++           +++           +++ #
#########################                   ###############
#########################^^^^^^^^^^^^^^^^^^^###############
#########################^^^^^^^^^^^^^^^^^^^###############
#########################^^^^^^^^^^^^^^^^^^^###############
#########################EEEEEEEEEEEEEEEEEEE###############
#########################EEEEEEEEEEEEEEEEEEE###############
#########################EEEEEEEEEEEEEEEEEEE###############
#########################EEEEEEEEEEEEEEEEEEE###############
#########################EEEEEEEEEEEEEEEEEEE###############
#########################EEEEEEEEEEEEEEEEEEE###############
#########################EEEEEEEEEEEEEEEEEEE###############
#########################EEEEEEEEEEEEEEEEEEE###############
#########################EEEEEEEEEEEEEEEEEEE###############
#########################EEEEEEEEEEEEEEEEEEE###############

E = entrance	> = arrow 1	
X = exit		< = arrow 2	
# = wall		^ = arrow 3	
+ = crossroad	v = arrow 4	
% = "SALE" :)	. = slow motion zone	
: = very slow motion  zone

Alexey A. Tsukanov, 2020.